8 9
/////////
//////--/
//////12/
/---1-12/
/-101222/
/-11122//
/--1-22//
/////////