9 9
/////////
////--///
///---///
/--121-//
/--2/2--/
///121--/
///--0///
///--////
/////////