9 11
///////////
//--//---//
//---1---//
//1-///-1//
//-/222/-//
//-/222/-//
/-1--1--1-/
/-----/-0-/
///////////